#########
#0#     #
# #  ## #
# ##  # #
#     #1#
#########
