#########
#0   #1 #
#   ### #
# #   # #
# # #   #
#########
