############
#0#1#   #o #
# # #      #
# #   # ## #
# ####     #
#        ###
# ####  # o#
#   o##   ##
############
